55,55,55,55,55,55,55,55,55,55,55,55,55,55,55,55
55,55,55,55,55,55,55,55,55,55,55,22,55,55,55,55
55,55,55,56, 2, 2, 2, 8, 8, 8, 8, 8, 2, 2, 2, 2
55,55,56, 2, 2, 3, 5, 2, 3, 5, 2, 2, 2, 2, 2, 2
55,56, 2, 2, 2,21,23, 2,21,23, 2, 2, 2, 2, 2, 2
55, 2, 2, 2, 2, 2, 2, 2, 2, 2, 2, 2, 2, 2, 2, 2
55,38, 2, 2, 2, 2, 3, 5, 2, 3, 5, 2, 2, 2, 2, 2
55,55,38, 2, 2, 2,21,23, 2,21,23, 2, 2, 2, 2, 2
55,55,55,38, 2, 2, 2, 2, 2, 2, 2, 2, 8, 2, 2, 2
55,55,55,55,37,37,37,37,37,37,37,37,37,37,37,37