67,67,14,14,14,14,14,14,14,14,14,14,14,14,67,67
67,67,14,14,14,14,14,14,14,14,14,14,14,14,66,67
67,67,14,14,14,14,14,14,14,14,14,14,14,14,14,14
67,67,14,14,14,14,14,14,14,14,14,14,14,14,14,14
67,67,14,14,14,14,14,14,14,14,14,14,14,14,14,14
67,67,14,14,14,14,14,14,14,14,14,14,14,14,14,14
67,67,14,14,14,14,14,14,14,14,14,14,14,14,14,14
67,67,14,14,14,14,14,14,14,14,14,14,14,14,14,14
67,67,14,14,14,14,14,14,14,14,14,14,14,14,14,14
67,67,14,14,14,14,14,14,14,14,14,14,14,14,48,49