55,55,55,55,55,55,55,55,55,55,55,55,55,55,55,55
55,55,55,55,55,55,55,56,54,55,55,55,55,55,55,55
55,55,55,55,56,54,56, 2, 2,54,55,55,55,55,55,55
55,55,55,56, 2, 2, 2, 2, 2, 2,55,55,55,55,55,55
56,54,56, 2, 2, 2, 2, 2, 2, 2,54,56,54,56,54,55
 2, 2, 2, 2, 2, 2, 2, 2, 2, 2, 2, 2, 2, 2, 2, 2
38,36,38, 2, 2, 2, 2, 2, 2, 2,36,38,36,38,36,37
55,55,55,38, 2, 2, 2, 2, 2, 2,55,55,55,55,55,55
55,55,55,55,38,36,38, 2, 2,36,55,55,55,55,55,55
55,55,55,55,55,55,55,38,36,55,55,55,55,55,55,55