55,55,55,55,55,55,55,55,55,55,55,55, 2, 2,55,55
55,55,55,55,55,55,55,55,55,55,22,55, 2, 2,55,55
55,55,55,55,55,55,55,56, 2, 2, 2, 2, 2, 2, 2, 2
55,55,55,55,55,55,56, 2, 2, 2, 2, 2, 2, 2, 2, 2
55,56,54,55,55,56, 2, 2, 2, 2, 2, 2, 2, 2, 2, 2
 2, 2, 2, 2, 2, 2, 2, 2, 2, 2, 2, 2, 2, 2, 2, 2
37,38,36,37,38, 2, 2,72,73,73,73,73,73,73,73,73
55,55,55,55,55,38, 2,90,91,91,91,91,91,91,91,91
55,55,55,55,55,55,38,90,91,91,91,91,91,91,91,91
55,55,55,55,55,55,55,90,91,91,91,91,91,91,91,91
