55,55,55,55,55,55,55,55,55,55,55,55,55,55,55,55
55,55,55,55,55,22,55,55,55,55,55,55,55,55,55,55
 2, 2, 2, 2, 2, 2, 2, 2, 2, 2, 2, 2, 2, 2, 2, 2
 2, 2, 2, 2, 2, 2, 2, 2, 2, 2, 2, 2, 2, 2, 2, 2
 2, 2, 2, 2, 2, 2, 2, 2, 2, 2, 2, 2, 2, 2, 2, 2
 2, 2, 2, 2, 2, 2, 2, 2, 2, 2, 2, 2, 2, 2, 2, 2
73,73,73,73,73,73,73,73,73,73,73,73,73,73,73,73
91,91,91,91,91,91,91,91,91,91,91,91,91,91,91,91
91,91,91,91,91,91,91,91,91,91,91,91,91,91,91,91
91,91,91,91,91,91,91,91,91,91,91,91,91,91,91,91
