55,55,55,55,55, 2, 2, 2,90,91,91,91,91,91,91,91
55,55,55,55,55, 2, 2, 2,90,91,91,91,91,91,91,91
55,55,55,55,55, 2, 2, 2,90,91,91,91,91,91,91,91
56,54,55,55,56, 2, 2, 2,90,91,91,91,91,91,91,91
 2, 2, 2, 2, 2, 2, 2, 2,90,91,91,91,91,91,91,91
 2, 2, 2, 2, 2, 2, 2,129,91,91,91,91,91,91,91,91
73,73,73,73,73,73,73,91,91,91,91,91,91,91,91,91
91,91,91,91,91,91,91,91,91,91,91,91,91,91,91,91
91,91,91,91,91,91,91,91,91,91,91,91,91,91,91,91
91,91,91,91,91,91,91,91,91,91,91,91,91,91,91,91
