19,19,19,19,19,19,19,19,19,19,19,19,19,19,19,19
19,19,19,19,19,19,19,19,19,19,19,19,19,19,19,19
19,19, 2, 2, 2, 2, 2, 2, 2, 2, 2, 2,19,19,19,19
19, 2, 2, 2, 2, 2, 2, 2, 2, 2, 2, 2,19,19,19,19
19, 2, 2,19, 2,19, 2,19, 2,19, 2, 2, 2, 2, 2, 2
19, 2, 2, 2, 2, 2, 2, 2, 2, 2, 2, 2, 2, 2, 2, 2
19, 2, 2,19, 2,19, 2,19, 2, 0, 2, 2, 2, 2, 2, 2
19, 2, 2, 2, 2, 2, 2, 2, 2, 2, 2, 2,19,19,19,19
19,19, 2, 2, 2, 2, 2, 2, 2, 2, 2, 2,19,19,19,19
19,19,19,19,19,19,19,19,19,19, 2, 2,19,19,19,19