19,19,19,19,19, 2, 2,19,19,19,19,19,19,19,19,19
19,19,19,19,19, 2, 2,19,19,19,19,19,19,19,19,19
19,19,19,19,19, 2, 2, 2, 2, 2, 2, 2, 2, 2, 2, 2
19,19,19,19,19,19,19,19,19,19,19,19,19,19,19,19
 2, 2,19,19,19,19,19,19,19,19,19,19,19,19,19,19
 2, 2, 2, 2, 2, 2,19,19,19,19,19,19,19,19,19,19
 2, 2, 2, 2, 2, 2,19,19,19,19,19,19,19,19,19,19
19,19, 2, 2, 2, 2,19,19,19,19,19,19,19,19,19,19
19,19, 2, 2, 2, 2, 2, 2, 2, 2, 2, 2, 2, 2, 2, 2
19,19,19,19,19,19,19,19,19,19,19,19,19,19,19,19
