61,61,61,61,61,61,61,61,61,61,61,61,61,61,61,61
61,61,61,61,61,61,61,61,61,61,61,61,61,61,61,61
61,62, 2, 2, 2, 2, 2, 2, 2, 2, 2, 2, 2, 2,60,61
62, 2, 2, 2, 2, 2, 2,39,40,41, 2, 2, 2, 2, 2,61
 2, 2, 2, 2,20, 2,20,57,22,59,20, 2,20, 2, 2,61
 2, 2, 2, 2, 2, 2, 2, 2, 2, 2, 2, 2, 2, 2, 2,61
 2, 2, 2, 2,20, 2,20, 2, 2, 2,20, 2,20, 2, 2,61
44, 2, 2, 2, 2, 2, 2, 2, 2, 2, 2, 2, 2, 2, 2,61
61,44, 2, 2, 2, 2, 2, 2, 2, 2, 2, 2, 2, 2,42,61
61,61,43,43,43,43,43,43,43,43,43,43,43,43,61,61
