61,61,61, 2, 2,61,61,61,61, 2, 2,61,61, 2,61,61
61,61,61, 2, 2,60,61,22,62, 2, 2,60,62, 2,60,61
61,61,62, 2, 2, 2, 2, 2, 2, 2, 2, 2, 2, 2, 2, 2
60,62, 2, 2, 2, 2, 2, 2, 2, 2, 2, 2, 2, 2, 2, 2
 2, 2, 2, 2, 2, 2,25, 2, 2, 2, 2, 2, 2, 2, 2, 2
 2, 2, 2, 2, 2, 2, 2, 2, 2, 2, 2, 2, 2, 2, 2, 2
 2, 2, 2, 2, 2, 2,25, 2, 2, 2, 2, 2, 2, 2, 2, 2
42,44, 2, 2, 2, 2, 2, 2, 2, 2, 2, 2, 2, 2, 2, 2
61,61,44, 2, 2, 2, 2, 2, 2, 2, 2, 2, 2, 2, 2, 2
61,61,61,43,43,43,43,43,43,43,43,43,43,43,43,43

