61,61,61,61, 2,91,91,61,61,61,61,61,61,61,61,61
61,61,22,62, 2,91,91,60,61,61,61,61,61,61,61,61
61,62, 2, 2, 2,91,91, 2, 2, 2, 2, 2, 2, 2, 2, 2
61, 2, 2, 2, 2,91,91, 2, 7, 2, 2, 2, 7, 2, 2, 2
61, 2, 2, 2, 2,91,91, 2, 2, 2, 7, 2, 2, 2, 2, 2
61, 2, 2, 7, 2,91,91, 2, 7, 2, 2, 2, 7, 2, 2, 2
61, 2, 2, 2, 2,91,91, 2, 2, 2, 7, 2, 2, 2, 2, 2
61, 2, 2, 2, 2,91,91, 2, 7, 2, 2, 2, 7, 2, 2, 2
61,44, 2, 2, 2,91,91, 2, 2, 2, 2, 2, 2, 2, 2, 2
61,61,43,43,44,91,91,42,43,43,43,43,43,43,43,43
