61,61, 2, 2, 2,97,97, 2, 2, 2,61, 2,61, 2,61,61
61,62, 2, 2, 2,97,97, 2, 2, 2,61, 2,61, 2,60,61
 2, 2, 2, 2, 2,91,91, 2, 2, 2, 2, 2, 2, 2, 2, 2
 2, 2, 2, 2, 2,91,91, 2, 2, 2, 1, 2, 2, 2, 2, 2
 2, 2, 2, 2, 2,91,91, 2, 2, 2, 2, 2, 1, 2, 2, 2
 2, 2, 2, 2, 2,131,131,2,2, 2, 1, 2, 2, 2, 2, 2
 2, 2, 2, 2, 2,91,91, 2, 2, 2, 2, 2, 1, 2, 2, 2
 2, 2, 2, 2, 2,91,91, 2, 2, 2, 1, 2, 2, 2, 2, 2
 2, 2, 2, 2, 2,91,91, 2, 2, 2, 2, 2, 2, 2, 2, 2
43,43,43,44, 2,97,97,43,43,43,43,43,43,43,43,43
