61,61,61,61,61,61,61,61,61,61,61,61, 8, 2,61,61
61,61,61,61,61,61,61,61,61,61,61,62, 2, 2,61,61
 2, 2, 2, 2, 2, 2, 2, 2, 2, 2, 2, 2, 2, 2,61,61
 2, 2, 2, 2, 2, 2, 2, 2, 7, 2, 2, 2, 2, 2,60,61
 2, 2, 2, 2, 2, 2, 2, 2, 2, 2, 7, 2, 2, 2, 2,60
 2, 2, 7, 2, 2, 7, 2, 2, 7, 2, 2, 2, 2, 2, 2, 2
 2, 2, 2, 2, 2, 2, 2, 2, 2, 2, 7, 2, 2, 2, 2,42
 2, 2, 2, 2, 2, 2, 2, 2, 7, 2, 2, 2, 2, 2,42,61
 2, 2, 2, 2, 2, 2, 2, 2, 2, 2, 2, 2, 2, 2,61,61
43,43,43,43,43,43,43,43,43,43,43,43,43,43,61,61