61,61,61,61,61,61,61,61,61,61,61,61,61,61,61,61
61,61,61,61,61,61,61,22,61,61,61,61,61,61,61,61
 8, 8, 8, 8, 8, 8, 8, 8, 8, 8, 8, 8, 8, 8,60,61
 8, 8, 8, 1, 1, 1, 1, 8, 8, 8, 8, 8, 8, 8, 8,60
 8, 8, 8, 8, 8, 8, 8, 8, 1, 1, 1, 8, 8, 8, 8, 8
 8, 8, 8, 1, 1, 1, 1, 8, 8, 8, 8, 8, 8, 8, 8, 8
 8, 8, 8, 8, 8, 8, 8, 8, 1, 1, 1, 8, 8, 8, 8, 8
 8, 8, 8, 1, 1, 1, 1, 8, 8, 8, 8, 8, 8, 8, 8,42
 8, 8, 8, 8, 8, 8, 8, 8, 8, 8, 8, 8, 8, 8,42,61
43,43,43,43,43,43,43,43,43,43,43,44, 8, 8,61,61
