61,61,61,61,61,61,61, 2, 2,61,61,61,61,61,61,61
61,61,61,61,22,61,62, 2, 2,61,61,61,61,61,61,61
61,61,61,62, 2, 2, 2, 8, 8,61,61,61,61,61,61,61
61,61,62, 2, 2, 2, 2, 2, 2,61,61,61,61,61,61,61
61,62, 2, 2, 2, 2, 2, 2, 2,60,61,61,61,61,61,61
 2, 2, 2, 2, 2, 2, 2, 2, 2, 2, 2, 2, 2, 2, 2, 2
43,44, 2, 2, 2, 2, 2, 2, 2, 2, 2, 2, 2, 2,43,43
61,61, 2, 2, 2, 2, 2, 2, 2, 2, 2, 2, 2, 2,61,61
61,61,43,43,43,43,43,43,43,43,43,43,43,43,61,61
61,61,61,61,61,61,61,61,61,61,61,61,61,61,61,61