61,61,61,61,61,61,61,61,61,61,61,61,61,61,61,61
61,61,61,61,61,61,28,61,61,61,61,61,61,61,61,61
61,62, 2, 2, 2, 2, 2, 2,60,62, 2, 2, 2, 2,60,61
62, 2, 2, 2, 7, 2, 7, 2, 2, 2, 2, 2, 7, 2, 2,60
 2, 2, 2, 2, 2, 2, 2, 2, 2, 2, 2, 2, 2, 2, 2, 2
 2, 2, 2, 2, 2, 2, 2, 2, 2, 2, 2, 2, 2, 2, 2, 2
44, 2, 2, 2, 7, 2, 7, 2, 2, 2, 2, 2, 7, 2, 2,42
61,44, 2, 2, 2, 2, 2, 2, 2,42,44, 2, 2, 2,42,61
61,61,43,43,43,43,43, 2, 2,61,61,43,43,43,61,61
61,61,61,61,61,61,61, 2, 2,61,61,61,61,61,61,61