61,61,25, 2,25, 2,25, 2, 2,25, 2,25, 2,25, 2,25
61,61,25, 2,25, 2,25, 2, 2,25, 2,25, 2,25, 2,25
61,61, 2, 2, 2, 2, 2, 2, 2, 2, 2, 2, 2, 2, 2, 2
61,62, 2, 2, 2, 2,25, 2, 2,25, 2,25, 2,25, 2, 2
62, 2,25, 2,25, 2, 2, 2, 2, 2, 2, 2, 2, 2, 2, 2
 2, 2, 2, 2, 2, 2,25, 2, 2,25, 2,25, 2,25, 2, 2
44, 2,25, 2,25, 2, 2, 2, 2, 2, 2, 2, 2, 2, 2, 2
61,44, 2, 2, 2, 2,25, 2, 2,25, 2,25, 2,25, 2, 2
61,61, 2, 2, 2, 2, 2, 2, 2, 2, 2, 2, 2, 2, 2, 2
61,61,25,25,25,25,25,25,25,25,25,25,25,25,25,25
